1111111111
1010101011
1101010101
1010101011
1111111111